111111
10C0E1
100001
1P0001
111111