111111111
110C01C01
10C001101
100000001
100P00101
10000E1C1
111111111