111111111
100001001
10C000101
100000011
100P00001
10000E001
111111111