111111111111111111111111111111
10C0110000110000110000010C00E1
10000110000110000110C001000001
1P0001000001111100000011000011
100000000001100001100010010001
100001100000000001100C00100001
110001000001111100000011000011
100000000001100001100010010001
100001100000000001100C00100001
100001000001111100000011000011
100000000001100001100010010001
100001100000000001100C00100001
100001100001100001100000100001
111111111111111111111111111111