111111111
100111111
10C1000C1
100101111
100P00001
100B0E001
111111111