1111111111
1CB0000EB1
1011000101
10100001C1
1000C00001
1011100B01
101C00B001
1011100001
1P0000C001
1111111111