1111111111111111111111111111111111
1EC0000000000000C00B00C00000000001
1C11110100100000101001000000010101
1011110B10101010001001000000010101
1P0000000C00C000000000001C10000001
1010110100100000101001000000010101
1010110010101010001001000000010101
1010110100100000101001000000010101
1000CB0010101010001001000000010101
1010110100100C00101001000B0001B101
101011001010101000100100000001C1C1
1111111111111111111111111111111111