111111111111111111
10011B111100P11111
10C1000C000C1000C1
100101111100101111
100000000000101111
100B0E001000B000C1
111111111111111111