111111
10C1E1
10P011
100001
111111
